####################################
#----------------@-----------------#
#----------------------------------#
#-------------##########-----------#
#----------------------------------#
#---########-------------########--#
#----------------------------------#
#-------------##########-----------#
#----------------!-----------------#
#----------------------------------#
####################################
