####################################
#-*---------#+---------------------#
#----#------#----------------.-----#
#----#-----L#-----=----#-----------#
#----#----#####-------#######------#
#----#-----------------#-----------#
#-----------#-----###----###-------#
#--------####$-----#F----###---##--#
#-----------#------#-----------##--#
#S--------------------------------@#
####################################
