####################################
#--@---------#---------------------#
#-------------#-----------#####----#
#----#----------------#-------#-$--#
#----######----.------#+------#----#
#--------F######------#####---#----#
#--------------#-----=-------------#
#------##-----------------L#####---#
#------##------#------######-------#
#S-------------------------------*-#
####################################
