####################################
#--@---------#---------------------#
#-------------#-----------#####----#
#----#----------------#-------#-$--#
#----######----.------#+------#----#
#--------F######------#####---#----#
#--------------#-----=-------------#
#------##-----------------L#####---#
#------##------#------######-------#
#--------------------------------*-#
####################################
