####################################
#@-##+----------$------------------#
#---#--------##---------F----##----#
#---##-------##---#-----##---#-----#
#-------#---------#-----##---##----#
#-------###------.###-------------*#
#--###-------S----#-----##---#-----#
#--#L------###----#----------#-----#
#--##------###-------##---####-----#
#--------------=-------------------#
####################################
